1111111111111
1000010000E01
10000000C0001
10000001P1001
1111111111111